{
    "0": "不可以",
    "1": "不喜歡",
    "2": "不客氣",
    "3": "不是",
    "4": "中午",
    "5": "今天",
    "6": "今天(現在)",
    "7": "休息",
    "8": "你好",
    "9": "公車",
    "10": "再見",
    "11": "去",
    "12": "可以",
    "13": "名字",
    "14": "告訴",
    "15": "喜歡",
    "16": "好吃",
    "17": "媽媽",
    "18": "對不起",
    "19": "幫忙",
    "20": "幾點",
    "21": "忘記",
    "22": "我",
    "23": "我們",
    "24": "找",
    "25": "放學",
    "26": "明天",
    "27": "是",
    "28": "會",
    "29": "有",
    "30": "有沒有",
    "31": "朋友",
    "32": "棒",
    "33": "機車",
    "34": "檢查",
    "35": "沒關係",
    "36": "火車",
    "37": "爸爸",
    "38": "生氣",
    "39": "蘋果",
    "40": "要",
    "41": "計程車",
    "42": "記得",
    "43": "認真",
    "44": "說話",
    "45": "謝謝",
    "46": "還沒",
    "47": "飛機",
    "48": "飲料",
    "49": "高興",
    "50": "高鐵"
}